4    5    5    5    5    5    5    5    5    5    5    5    5    5    5    5    6
12   0    0    0    0    0    0    0    0    0    0    0    0    0    0    0    10
12   0    0    0    0    0    0    0    0    0    0    0    0    0    0    p1   10
12   0    0    0    0    0    0    0    0    0    0    0    0    0    0    p2   10
12   0    0    29   31   0    0    0    0    0    0    28   0    0    29   30   10
12   0    0    0    0    0    28   0    28   0    28   0    0    0    0    0    10
12   31   0    0    0    0    0    0    0    0    0    0    0    0    0    0    10
12   0    0    0    0    0    0    0    0    0    0    0    0    0    0    0    10
12   0    28   0    0    0    0    0    0    0    0    e    0    0    0    0    10
12   0    0    28   0    0    0    0    0    29   30   30   30   31   0    0    10
12   0    0    0    0    0    29   31   0    0    0    0    0    0    0    0    10
12   0    0    0    0    0    0    0    0    0    0    0    0    0    0    29   10
12   0    0    0    0    0    0    0    0    0    0    0    0    0    0    0    10
12   0    0    0    0    0    0    0    0    28   0    28   0    1    2    2    24
12   0    0    0    1    2    2    3    0    0    0    0    0    10   11   11   11
12   0    0    1    24   11   11   11   l    l    l    l    l    11   11   11   11
22   2    2    24   11   11   11   11   11   11   11   11   11   11   11   11   11