4    5    5    5    5    5    5    5    5    5    5    5    5    5    5    5    6
12   0    0    0    0    0    0    0    0    0    0    0    0    0    0    0    10
12   0    0    0    0    0    0    0    0    0    0    0    0    0    0    p1   10
12   m    0    0    0    0    0    0    0    0    0    0    0    0    0    p2   10
12   0    0    2    2    0    0    0    m    0    0    2    2    2    2    2    10
12   0    0    0    0    0    2    0    2    0    2    0    0    0    0    0    10
12   2    0    0    0    0    0    0    0    0    0    0    0    0    0    0    10
12   0    0    0    0    0    0    0    0    0    0    0    0    0    0    0    10
12   0    2    0    0    0    0    0    0    0    0    e    0    0    0    0    10
12   0    0    2    0    0    0    0    0    2    2    2    2    2    0    0    10
12   0    0    0    0    0    2    2    0    0    0    0    0    0    0    m    10
12   0    0    0    0    0    0    0    0    0    0    0    0    0    0    2    10
12   0    0    0    0    0    0    0    0    0    0    0    0    0    0    0    10
12   0    0    0    0    0    0    0    0    2    0    2    0    2    2    2    24
12   0    0    0    2    2    2    2    0    0    0    0    0    11   11   11   11
12   0    0    2    11   11   11   11   l    l    l    l    l    11   11   11   11
22   2    2    11   11   11   11   11   11   11   11   11   11   11   11   11   11

