4    5    5    5    5    5    5    5    5    5    5    5    5    5    5    5    6
12   0    0    0    0    0    0    0    0    0    0    0    0    0    0    0    10
12   0    0    0    0    0    0    0    0    0    0    0    0    0    0    p1   10
12   0    m    0    0    0    0    0    0    0    0    0    0    0    0    p2   10
12   0    0    0    0    0    2    2    2    0    2    2    2    0    2    2    10
12   0    0    0    0    0    0    0    0    0    0    0    0    0    0    0    10
12   0    0    0    2    0    0    0    0    0    0    0    0    0    0    0    10
12   0    0    0    0    0    0    0    0    0    0    0    0    0    0    0    10
12   0    2    0    0    0    0    0    0    0    0    0    0    0    0    0    10
12   0    0    0    0    0    0    0    0    0    0    0    0    0    0    m    10
12   0    0    0    2    0    0    0    0    0    0    0    0    0    0    2    10
12   0    0    0    0    0    0    0    0    0    0    0    0    0    0    0    10
12   0    2    0    0    0    0    0    0    0    0    0    0    2    0    0    10
12   0    0    0    0    0    0    0    0    0    m    0    0    0    0    0    10
12   0    0    0    2    0    0    0    0    0    0    0    0    0    0    2    10
22   2    2    2    11   2    0    0    0    0    0    0    0    0    0    0    10
11   11   11   11   11   11   2    2    l    2    l    2    l    2    2    2    24