4    5    5    5    5    5    5    5    5    5    5    5    5    5    5    5    6
12   0    0    0    0    0    0    0    0    0    0    0    0    0    0    0    10
12   0    0    0    0    0    0    0    0    0    0    0    0    0    0    0    10
12   0    0    0    0    0    0    0    0    0    0    0    0    0    0    0    10
12   0    0    0    0    0    0    0    0    0    0    0    0    0    0    0    10
12   0    0    0    0    0    0    0    0    0    0    0    0    0    0    0    10
12   0    0    0    0    0    0    0    0    0    0    0    0    0    0    0    10
12   0    0    0    0    0    0    0    0    0    0    0    0    0    0    0    10
12   0    0    0    0    0    0    0    0    0    0    0    0    0    0    0    10
12   0    0    0    0    0    0    0    0    0    0    0    0    0    0    0    10
12   0    0    0    0    0    0    0    0    p1   0    0    0    0    0    0    10
12   0    0    0    0    0    0    0    0    p2   0    0    0    0    0    0    10
12   0    0    0    0    2    2    2    2    2    0    0    0    0    0    0    10
12   0    0    0    0    0    0    0    0    0    0    0    0    0    0    0    10
12   2    2    2    0    0    0    0    0    0    0    0    0    0    0    0    10
12   0    0    0    0    0    0    0    0    0    0    0    0    0    0    0    10
22   11   11   11   11   11   11   11   11   11   11   11   11   11   11   11   24